data/pp_data/complex/1bid.pdb	data/pp_data/complex/1bid.pdb	ump
data/pp_data/complex/1cdo.pdb	data/pp_data/complex/1cdo.pdb	nad
data/pp_data/complex/1dwd.pdb	data/pp_data/complex/1dwd.pdb	mid
data/pp_data/complex/1fbp.pdb	data/pp_data/complex/1fbp.pdb	amp
data/pp_data/complex/1gca.pdb	data/pp_data/complex/1gca.pdb	gal
data/pp_data/complex/1hew.pdb	data/pp_data/complex/1hew.pdb	nag
data/pp_data/complex/1hyt.pdb	data/pp_data/complex/1hyt.pdb	bzs
data/pp_data/complex/1inc.pdb	data/pp_data/complex/1inc.pdb	icl
data/pp_data/complex/1rbp.pdb	data/pp_data/complex/1rbp.pdb	rtl
data/pp_data/complex/1rob.pdb	data/pp_data/complex/1rob.pdb	c2p
data/pp_data/complex/1stp.pdb	data/pp_data/complex/1stp.pdb	btn
data/pp_data/complex/1ulb.pdb	data/pp_data/complex/1ulb.pdb	gun
data/pp_data/complex/2ifb.pdb	data/pp_data/complex/2ifb.pdb	plm
data/pp_data/complex/3ptb.pdb	data/pp_data/complex/3ptb.pdb	ben
data/pp_data/complex/2ypi.pdb	data/pp_data/complex/2ypi.pdb	pga
data/pp_data/complex/4dfr.pdb	data/pp_data/complex/4dfr.pdb	mtx
data/pp_data/complex/4phv.pdb	data/pp_data/complex/4phv.pdb	vac
data/pp_data/complex/5cna.pdb	data/pp_data/complex/5cna.pdb	mma
data/pp_data/complex/7cpa.pdb	data/pp_data/complex/7cpa.pdb	fvf
data/pp_data/complex/1a6w.pdb	data/pp_data/complex/1a6w.pdb	nip
data/pp_data/complex/1blh.pdb	data/pp_data/complex/1blh.pdb	fos
data/pp_data/complex/1byb.pdb	data/pp_data/complex/1byb.pdb	glc
data/pp_data/complex/1hfc.pdb	data/pp_data/complex/1hfc.pdb	plh
data/pp_data/complex/1igj.pdb	data/pp_data/complex/1igj.pdb	dgx
data/pp_data/complex/1imb.pdb	data/pp_data/complex/1imb.pdb	lip
data/pp_data/complex/1ivd.pdb	data/pp_data/complex/1ivd.pdb	st1
data/pp_data/complex/1mrg.pdb	data/pp_data/complex/1mrg.pdb	adn
data/pp_data/complex/1mtw.pdb	data/pp_data/complex/1mtw.pdb	dx9
data/pp_data/complex/1okm.pdb	data/pp_data/complex/1okm.pdb	sab
data/pp_data/complex/1pdz.pdb	data/pp_data/complex/1pdz.pdb	pga
data/pp_data/complex/1phd.pdb	data/pp_data/complex/1phd.pdb	pim
data/pp_data/complex/1qpe.pdb	data/pp_data/complex/1qpe.pdb	pp2
data/pp_data/complex/1rne.pdb	data/pp_data/complex/1rne.pdb	c60
data/pp_data/complex/1snc.pdb	data/pp_data/complex/1snc.pdb	thp
data/pp_data/complex/1srf.pdb	data/pp_data/complex/1srf.pdb	mtb
data/pp_data/complex/2ctc.pdb	data/pp_data/complex/2ctc.pdb	hfa
data/pp_data/complex/2h4n.pdb	data/pp_data/complex/2h4n.pdb	azm
data/pp_data/complex/2pk4.pdb	data/pp_data/complex/2pk4.pdb	aca
data/pp_data/complex/2sim.pdb	data/pp_data/complex/2sim.pdb	dan
data/pp_data/complex/3gch.pdb	data/pp_data/complex/3gch.pdb	oac
data/pp_data/complex/3mth.pdb	data/pp_data/complex/3mth.pdb	mpb
data/pp_data/complex/5p2p.pdb	data/pp_data/complex/5p2p.pdb	dhg
data/pp_data/complex/6rsa.pdb	data/pp_data/complex/6rsa.pdb	uvc